|||||||||||||||
|C         C|||
|||| ||| ||||||
|||| |||     ||
|   M  C C|| ||
|C|| ||||||| ||
||||  C  |||C||
|||||||||||||||
