        ||||||||||||||
        |           C|
||||||||| ||||||||||||
|M                   |
||||||||||||||||||||||
