        ||||||||||||||
        |           C|
||||||||| ||||||||||||
|M                  C|
||||||||||||||||||||||
