        ||||||||||||||
        |            |
||||||||| ||||||||||||
|M                  C|
||||||||||||||||||||||
