||||||||||||||||||||||
||||||||||||| ||||||||
||||||||||||| ||||||||
||||||||||||| ||||||||
||||||||||||| ||||||||
|M                   |
||||||||||||| ||||||||
||||||||||||| ||||||||
||||||||||||| ||||||||
||||||||||||| ||||||||
|||||||||||||C||||||||
||||||||||||||||||||||
