||||||||||||||||||||||||||||||||||||
||        ||||||||||||      ||||||||
|| |||||| ||||||||M||| |||||||||||||
|| |||||| |||||||| ||| |||        ||
|| |||||| |||||||| ||| ||| |||||| ||
|| |               ||| ||| |||||| ||
|| ||||||||||||||| ||| ||| |||||| ||
|| |||||| ||| ||||          ||||| ||
|| |||||| ||| |||| |||||||||||||| ||
|| |||             |||||          ||
|||||||||||||||||||||||| |||||||| ||
|||C||                   |||      ||
||| ||||||||| |||||| |||||||||||||||
|||           ||||||               |
||||||||||||||||||||||||||||||||||||
