|||||||||||||||||||||||
|M                  C||
| ||||||||| |||||||| ||
| ||||||||| |||||||| ||
| ||||||||| |||||||| ||
|                    ||
|||||||||||||||||||||||
