|||||||||||||||||||||||
|M     C             ||
| ||||||||| |||||||| ||
| ||||||||| |||||||| ||
| ||||||||| |||||||| ||
|                    ||
|||||||||||||||||||||||
