|||||||||||||||||||||||
|M                   ||
| ||||||||| |||||||| ||
| ||||||||| |||||||| ||
| ||||||||| |||||||| ||
|                   C||
|||||||||||||||||||||||
