|||||||||||||||||||||||
|M                   ||
| |||||||||||||||||| ||
| |||||||||C|||||||| ||
| ||||||||| |||||||| ||
|                    ||
|||||||||||||||||||||||
