|||||||||||||||||||||||
|M                   ||
| ||| || || || || || ||
| ||| || || || ||C|| ||
| ||| || || || || || ||
|                    ||
|||||||||||||||||||||||
