||||||||
|     M|
| | ||||
| |    |
| ||||||
|      |
|||||| |
| ||   |
|C|C | |
||||||||
