||||||||||||||||||||
|                  |
| |||||||||||||||| |
|||              | |
| | |||||||||||| | |
|C| |         M| | |
||| | |||||||||| | |
  | |            | |
  | |||||||||||||| |
  |                |
  ||||||||||||||||||
