|||||||||||
|M       C|
|         |
|         |
|         |
|         |
|||||||||||
