|||||||||||
|M        |
|         |
|         |
|         |
|C        |
|||||||||||
