|||||||||||
|M        |
|         |
|         |
|         |
|       C |
|||||||||||
