|||||||||||
|M        |
|      C  |
|         |
|         |
|         |
|||||||||||
