||||||||||||||||||||||||
||           |||||||||||
||        C  |||||||||||
||           |||||||||||
||           |||||||||||
||||||| ||||||||||||||||
||||||| ||||||||||||||||
||||||| |||         ||||
||||||| |||   M     ||||
||||||| |||         ||||
|||||||                |
||||||||||||||||||||||||
