||||||||||||||||||||
|                  |
| |||||||||||||||| |
| |              | |
| | |||||||||||| | |
|C| |M         | | |
||| | |||||||||| | |
  | |            | |
  | |||||||||||||| |
  |                |
  ||||||||||||||||||
