.........
........X
..X......
.....XX..
.........
.........
